41
41
1010
11111111111111111111111111111111111111111
10000000001111111111111111111111110000001
10000000001111111111111111111111110000001
10000000011000000000000000000111110000001
10000001110000000000000000000011110000001
10000001000000000000000000000001110000001
1000000d000000000000000000000000110000001
11111111100000000000000000000000010000001
10000000110000000000000000000001111100011
10000000011000000000000000000011000000001
10000000001100000000000000000111000000001
10000000000110000000000000001101000000001
10000000000011000000000000011001000000001
11111100000001100000000000110001000000001
100001100000001100000000011000011111d1111
10000011000000010000000011000001000000001
10000001100000010000000010000000000000001
10000000110000010000000010000000000000001
00000000010000010000000010000000000000000
00000000010000010000000010000001000000000
00000000010000010000000010000001000000000
00000000010000010000000000000001000000000
00000000000000010000000000000001000000000
10000000000000010000000000000001100000001
10000000000000010000000010000000110000001
10000000010000010000000010000000011000001
11111111110000110000000011000000001100001
10000000000001100000000001100000000111111
10000000000011000000000000110000000000001
10000000000110000000000000011000000000001
10000000001100000000000000001100000000001
10000000011000000000000000000110000000001
11000111110000000000000000000011110000001
10000000000000000000000000000001111111111
100000000000000000000000000000000d0000001
10000000000000000000000000000000110000001
10000001111100000000000000000001110000001
10000001111110000000000000000011110000001
10000001111111111111111111111111110000001
10000001111111111111111111111111110000001
11111111111111111111111111111111111111111